W W W W W W W W W W W W W W W W W W W W W W W W W W W W W W W W W W W W W W W W
W G G G G G G G G G G G G G G G G G G G G G G G G M M M M M M M G G G G G G G W
W G G G G G G G G G G G G G G G G G G G G G G G G M M M M M M M G G G G G G G W
W G G G G G G G G G G G G G G G G G W W W G G G G M M M M M M M G G G G G G G W
W G G G G G G G G G G G G G G G G G W W W G G G G M M M M M M M G G G G G G G W
W G G G G G G G G G W W W G G G G G W W W G G G G M M M M M M M G G G G G G G W
W G G G G G G G G G W W W G G G G G G G G G G G G M M M M M M M G G G G G G G W
W G G G G G G G G G W W W G G G G G G G G G G G G M M M M M M M G G G G G G G W
W G G G G G G G G G G G G G G G G G G G G G G G G G G G M M M G G G G G G G G W
W G G G G G G G G G G G G G G G G G G G G G G G G G G G M M M G G G G G G G G W
W G G G G G G G G G G G G G G G G G G G G G G G G G G G G G G G G G G G G G G W
W G G G G G G G G G G G G G G G G G G G G G G G G G G G G G G G G G G G G G G W
W G G G G G G G G G G G G G G G G G G G G G G G G G G G G G G G G G G G G G G W
W G G G G G G W W W W W W W G G G G G G G G G G G G G G G G G G G G G G G G G W
W G G G G G G W W W W W W W M M M G G G G G G G G G G G G G G G G G G G G G G W
W G G G G G G W W W W W W W M M M G G G G G G G G G G G G G G G G G G G G G G W
W G G G G G G W W W W W W W M M M G G G G G G G G G G G G G G G G G G G G G G W
W G G G G G G W W W W W W W G G G G G G G G G G G G G G G G G G G G G G G G G W
W G G G G G G W W W W W W W G G G G G G G G G G G G G G G G G G G G G G G G G W
W G W W W W W W W W W W W W G G G G G G W W W W W G G G G G G G G G G G G G G W
W G W W W W W W W G G G G G G G G G G G W W W W W G G G G G G G G G G G G G G W
W G W W W W W W W G G G G G G G G G G G W W W W W G G G G G G G G G G G G G G W
W G W W W W W W W G G G G G G G G G G G W W W W W G G G G G G G G G G G G G G W
W G W W W W W W W G G G G G G G G G G G W W W W W G G G G G G G G G G G G G G W
W G W W W W W W W G G G G G G G G G G G G G G G G G G G G G G G G G M M M M M W
W G W W W W W W W G G G G M M M G G G G G G G G G G G G G G G G G G M M M M M W
W G G G G G G G G G G G G M M M G G G G G G G G G G G G G G G G G G M M M M M W
W G G G G G G G G G G G G M M M G G G W W W W W W W G G G G G G G G M M M M M W
W W W G G G G G G G G G G G G G G G G W W W W W W W G G G G G G G G M M M M M W
W W W G G M M M M M M M W W W W W G G W W W W W W W G G G G G G G G G G G G G W
W W W G G M M M M M M M W W W M M M M M M M W W W W G G G G G G G G G G G G G W
W G G G G M M M M M M M W W W M M M M M M M W W W W G G G G G G G G G G G G G W
W G G G G M M M M M M M W W W M M M M M M M W W W W G G G G G G G G G G G G G W
W G G G G M M M M M M M W W W M M M M M M M W W W W G G G G G G G G G G G G G W
W G G G G M M M M M M M W W W M M M M M M M G G G G G G G G G G G G G G G G G W
W G G M M M M M M M M M W W W M M M M M M M M G G G G G G G G G G G G G G G G W
W G G M M M G G G G G G G G G M M M M M M M M G G G G G G G G G G G G G G G G W
W G G M M M G G G G G G G G G M M M M M M M M G G G G G G G G G G G G G G G G W
W G G G G G G G G G G G G G G G G G M M M M M G G G G G G G G G G G G G G G G W
W W W W W W W W W W W W W W W W W W W W W W W W W W W W W W W W W W W W W W W W