W W W W W W W W W W W W W W W W W W W W W W W W
W G G W G G G G G G G G G G G G G G G G G G G W
W G G G G W G G G G G G W G G G G W G G G G G W
W G W G G G G G G G G G G G G G G G G G G G G W
W G G G G G G W G G G G G G G G G G G G G W G W
W G G G G G G G G G G G G G W G G G G G G G G W
W G G G W G G G G G G G G G G G G G G G G G G W
W G G G G G G G W M M M M M M W G G G G G G G W
W G G G G G G G M M M M M M M M G G G G G G W W
W G W G G G G G M M M M M M M M G G G G G G G W
W G G G G G G G W M M M M M M W G G G G G G G W
W G G G G G G G G G G G G G G G G G G G G G G W
W G G G G G W G G G G G G G G G G G G G G G G W
W G G G G G G G G G G G G G G G G G G G G G G W
W G G G G G G G G G G G G G G G G G G G G G G W
W G G G G G G G G G G G G G G G G G G G G G G W
W G G G G G G G G G G G G G G G G G G G G G G W
W W W W W W W W W W W W W W W W W W W W W W W W